55555555555555555555555555555555
50000000000000033000000000000005
50000000000000033000000000000005
50033333333210033001233333333005
50032100000110033001100000123005
50031100000000000000000000113005
50030000000000000000000000003005
50030000000000000000000000003005
50021000000000000000000000012005
50011000000000000000000000011005
50000000000000000000000000000005
50000000000111111111100000000005
50000000000111111111100000000005
50000000000112222221100000000005
50000000000112222221100000000005
53333000000112233221100000033335
53333000000112233221100000033335
50000000000112222221100000000005
50000000000112222221100000000005
50000000000111111111100000000005
50000000000111111111100000000005
50000000000000000000000000000005
50011000000000000000000000011005
50021000000000000000000000012005
50030000000000000000000000003005
50030000000000000000000000003005
50031100000000000000000000113005
50032100000110033001100000123005
50033333333210033001233333333005
50000000000000033000000000000005
50000000000000033000000000000005
55555555555555555555555555555555
