********************************
*                              *
*  *************    *********  *
*  *                        *  *
*  *                        *  *
*  *                        *  *
*  *                        *  *
*  *                        *  *
*  *                        *  *
*  *                        *  *
*  *      ***********       *  *
*              *               *
*              *               *
*              *               *
*              *               *
*  *      ***********       *  *
*  *                        *  *
*  *                        *  *
*  *                        *  *
*  *      ***********       *  *
*              *               *
*              *               *
*              *               *
*              *               *
*  *      ***********       *  *
*  *                        *  *
*  *                        *  *
*  *                        *  *
*  *************    *********  *
*                              *
*                              *
********************************